NO textures/N.xpm
EA textures/E.xpm
SO textures/S.xpm
WE textures/W.xpm
DOOR textures/door.xpm

C 255,255,255
F 255,255,255

11111111111111111111111
10000000000000000000001
10000000000000000000001
10000000000000000000001
1000000000N000000000001
10000000000000000000001
10000000000000000000001
10000000000000000000001
11111111111111111111111
