NO textures/Orange6.xpm
EA textures/Orange8.xpm
SO textures/Red14.xpm
WE textures/Wood1.xpm


C 121,50,20
F 1,11,48

11111111111111111111111
10000000000000000000001
10000000000000000000001
100000000000000S1000001
10000000000000010000001
10000000000000000000001
10000000000000000000001
10000000000000000000001
11111111111111111111111
