NO textures/N.xpm
EA textures/E.xpm
SO textures/S.xpm
WE textures/W.xpm

C 30,200,100
F 2,25,120

11111111111111111111111
10000000000000000000001
11111111111101111111111
10000000000000000000001
1000000000N001111111101
10111000000000000000001
10000001111111011111001
11111100000000000000001
11111111111111111111111
