NO textures/Orange6.xpm
EA textures/Orange8.xpm
SO textures/Red14.xpm
WE textures/Wood1.xpm
DOOR textures/door.xpm
C 121,50,20
F 1,11,48

11111111111111111111111
100000N0000000000000001
10000000011100000000001
10000000100010000000001
10000000000000000000001
10000000000000000000001
10000000000000000000001
10000000000000000000001
11111111111111111111111
