NO textures/simonkraft/respawn_anchor_side0.xpm
EA textures/simonkraft/respawn_anchor_side2.xpm
SO textures/simonkraft/respawn_anchor_side4.xpm
WE textures/simonkraft/respawn_anchor_side3.xpm

DOOR_CLOSED textures/bonus/door_closed.xpm
DOOR_OPEN textures/bonus/door_open.xpm
KEY         textures/bonus/key.xpm
ANIM_0      textures/bonus/enemy_0.xpm
ANIM_1      textures/bonus/enemy_1.xpm

C 35,19,73
F 15,6,40

11111111111111111111111111111111111111111111111
10000000000000000111110000000000000000000111001
10000000000010000100000000000000010011110000001
10000000111110000000000000000000010000000000001
10000000000000000001110000000000000111110000001
10000000111110000000000000000000000000000000001
10000000100000000000000000000000000000001000001
1E000000100000001111111111100000010000000000001
1000000010000001           10000000000001000001
1000000010001111           10000000000001000001
10000000100000001111111111100000010000000000001
10000000000011111000000000000000010000000000001
10000000000000000000000000000000000000001000001
11111111111111111111111111111111111111111111111
