NO textures/simonkraft/respawn_anchor_side0.xpm
EA textures/simonkraft/respawn_anchor_side2.xpm
SO textures/simonkraft/respawn_anchor_side4.xpm
WE textures/simonkraft/respawn_anchor_side3.xpm

DOOR_CLOSED textures/bonus/door_closed.xpm
DOOR_OPEN textures/bonus/door_open.xpm
KEY         textures/bonus/key.xpm
ANIM_0      textures/bonus/enemy_0.xpm
ANIM_1      textures/bonus/enemy_1.xpm

C 35,19,73
F 15,6,40

11111111111111111111111111111111111111111111111111111111111
10000001000000000100000001000000000100000000010000000001001
100000010000000001000000010000000001000000000100000000010011111111111111111111111111111111
100000010000000001000000010000000001000000000000000000000000010000000010000000000000000001
100000010000000001000000010000000000000000000100000000000000000000000000000000000000000001
1W0000010000000001000000010000000001000000000100000000000000010000000010000000100000000001
100000010000000001000000010000000001000000000100000000010111111111111111111111111111111111
1000000100000000010000000100000000010000000001000000000011
100000010000000001000000010000000001000000000100000000010011111111111111111111111111111111
100001010000000001000000010000000001000000000100000000000000000000000000000000000000000001
10000D0D000000000D000000000000000001000000000100000000010001111111111111111111111111111111
100001010000000001000000010000000001000000000000000000010001
100000000000000001000000010000000001000000000100000000010001111111111111111111111111111111
100000010000000001000000010000000001000000000100000000010000010000000010000000100000000001
100000010000000001000000010000000001000000000100000000010001111111111111111111111111111111
1000000100000000010000000100000000010000000001000000000100001
1000000100000000000000000100000000010000000000000000000100001
1000000000000000010000000100000000010000000001000000000111111
10000001000000000100000001000000000100000000010000000001
100000010000000001000000010000000000000000000100000000011111111111111111111111111111111111
100000000000000000000000010000000001000000000100000000010000010000000010000000100000000001
100000010000000001000000010000000001000000000100000000000000000000000000000000000000000001
100000010000000001000000010000000001000000000100000000010000010000000010000000100000000001
111111111111111111111111111111111111111111111111111111111111111111111111111111111111111111
