NO textures/Orange6.xpm
EA textures/Orange8.xpm
SO textures/Red14.xpm
WE textures/Wood1.xpm


C 121,50,20
F 1,11,48

111                      11111111111111
1001111111111111        100000000000001
1000000000000001        100000111111111111111111111111111
1000011111111111   11111000000000000000000000000000000001
100001            100000011111111111111111111111111000001
10000111111111111100000011111111111               1000001
10000000000000000000000000000000001               1000001
10000000000000010000000011111111111               1000001
1000N00000000000000000001                         1111111
10000000000000011111111111111111111
1000000000000001
111111111111111

